{
  "structure" : [
    ["w", "w", "w", "w", "e", "e", "w", "w", "w", "w"],
    ["w", " ", " ", " ", " ", " ", " ", " ", " ", "w"],
    ["w", " ", " ", " ", " ", " ", " ", " ", " ", "w"],
    ["w", " ", " ", " ", " ", " ", " ", " ", " ", "w"],
    ["e", " ", " ", " ", " ", " ", " ", " ", " ", "e"],
    ["e", " ", " ", " ", " ", " ", " ", " ", " ", "e"],
    ["w", " ", " ", " ", " ", " ", " ", " ", " ", "w"],
    ["w", " ", " ", " ", " ", " ", " ", " ", " ", "w"],
    ["w", " ", " ", " ", " ", " ", " ", " ", " ", "w"],
    ["w", "w", "w", "w", "e", "e", "w", "w", "w", "w"]
  ]
}