{
  "elements" : {
    "w" : "resources/images/tiles/wall_tile.png",
    " " : "resources/images/tiles/floor_tile.png"
  },
  "structure" : [
    ["w", "w", "w", "w", " ", " ", "w", "w", "w", "w"],
    ["w", " ", " ", " ", " ", " ", " ", " ", " ", "w"],
    ["w", " ", " ", " ", " ", " ", " ", " ", " ", "w"],
    ["w", " ", " ", " ", " ", " ", " ", " ", " ", "w"],
    [" ", " ", " ", " ", " ", " ", " ", " ", " ", " "],
    [" ", " ", " ", " ", " ", " ", " ", " ", " ", " "],
    ["w", " ", " ", " ", " ", " ", " ", " ", " ", "w"],
    ["w", " ", " ", " ", " ", " ", " ", " ", " ", "w"],
    ["w", " ", " ", " ", " ", " ", " ", " ", " ", "w"],
    ["w", "w", "w", "w", " ", " ", "w", "w", "w", "w"]
  ]
}